4 4 4 4 4 4 4 4 4 4 4 4 4 4 4 4 4 4 4 4 4 4 4 4 4 4 4 4 4 4 4 4 4 4 4 4 4 4 4 4 2 2 2 0 4 4 4 4 4 4
4 4 4 4 4 4 4 4 4 4 4 4 4 4 4 4 4 4 4 4 4 4 4 4 4 4 4 4 4 4 4 4 4 4 4 4 4 4 4 4 4 2 2 2 0 4 4 4 4 4
4 4 4 4 0 4 4 4 4 4 4 4 4 4 4 4 4 4 4 4 0 2 2 2 2 2 0 4 4 4 4 4 4 4 4 0 4 4 4 4 4 4 2 2 2 0 4 4 4 4
4 4 4 4 4 4 4 4 4 4 4 4 4 4 0 4 4 4 4 4 2 2 2 2 2 2 2 4 4 4 4 4 4 4 4 4 4 4 4 4 4 4 4 2 2 2 0 4 4 4
4 4 4 4 4 4 4 4 4 4 4 4 4 4 4 4 4 4 4 4 2 2 2 2 2 2 2 4 4 4 0 4 4 4 4 4 4 4 4 0 4 4 4 4 2 2 2 0 4 4
4 4 4 4 4 4 4 4 4 4 4 4 4 4 4 4 4 4 4 4 2 2 2 2 2 2 2 4 4 4 4 4 4 4 4 0 4 4 4 4 4 4 4 4 4 2 2 2 0 4
4 4 4 4 4 4 4 4 1 1 1 1 1 4 4 4 0 4 4 4 4 2 2 2 2 2 4 4 4 4 4 4 4 4 4 4 4 4 4 4 4 4 4 0 4 4 2 2 2 0
4 4 4 4 0 4 4 4 1 3 3 3 1 4 4 4 4 4 4 4 0 5 5 5 5 5 0 4 4 0 4 4 4 6 4 5 5 5 5 5 5 4 4 4 4 4 4 2 2 2
4 4 4 4 4 4 4 4 1 3 3 3 1 4 4 4 4 4 4 4 4 0 0 5 0 0 4 4 4 4 4 4 4 6 5 5 5 5 5 5 5 5 4 4 4 4 4 4 2 2
4 4 4 4 4 4 4 4 1 3 3 3 1 4 4 4 4 4 0 4 4 4 0 0 0 4 4 4 4 4 4 4 4 4 5 5 5 5 5 5 5 5 4 4 4 0 4 4 4 2
4 4 4 4 4 4 4 4 1 3 3 3 1 4 4 4 4 4 4 4 4 4 4 5 4 4 4 4 4 4 0 4 4 4 5 5 5 5 5 5 5 5 4 4 4 4 4 4 4 4
4 4 4 4 4 4 4 4 1 1 0 1 1 4 4 4 4 4 4 4 4 4 4 5 4 4 4 4 4 4 4 4 4 4 5 5 5 5 5 5 5 5 4 4 4 4 4 4 4 4
4 4 4 0 4 4 4 4 4 4 0 4 4 4 4 4 0 4 4 4 4 4 4 5 4 4 4 4 0 4 4 4 4 4 4 5 5 5 5 5 5 4 4 4 0 4 4 4 4 4
4 4 4 4 4 4 4 0 4 4 0 4 4 4 4 4 4 4 4 4 4 4 4 5 4 4 4 4 4 4 4 4 4 4 4 4 4 4 5 4 4 4 4 4 4 7 4 4 4 4
4 4 4 4 4 4 4 4 4 4 0 4 4 4 4 4 4 4 4 4 4 4 4 5 4 4 4 4 4 4 4 4 4 0 4 4 4 4 5 4 4 4 4 7 5 5 4 4 4 4
4 4 4 4 4 4 4 4 4 4 0 4 4 4 4 4 4 4 4 4 4 4 4 5 4 4 4 0 4 4 4 4 4 4 4 4 4 4 5 4 4 4 4 7 5 7 4 4 4 4
4 4 6 5 7 4 4 4 0 0 0 4 4 4 0 4 4 4 4 0 4 4 4 5 4 4 4 4 4 4 4 4 4 4 4 4 4 4 5 4 4 4 4 0 7 5 4 4 4 4
4 4 7 5 5 4 4 4 0 4 4 4 4 4 4 4 4 4 4 4 4 4 4 5 4 4 4 4 4 4 4 4 4 4 4 4 4 4 5 4 4 4 4 4 4 4 4 0 4 2
4 4 7 5 7 4 4 4 0 4 4 4 4 4 4 4 4 4 4 4 4 4 0 5 0 4 4 4 4 4 4 4 4 4 4 4 5 5 5 4 4 4 4 4 4 4 4 4 2 2
4 4 4 0 4 4 4 4 0 4 4 4 4 4 4 4 0 4 4 4 6 0 0 5 0 6 4 4 4 4 4 4 4 4 4 4 5 4 4 4 4 4 4 4 4 4 4 2 2 2
4 4 4 4 4 4 4 4 0 4 4 4 4 4 4 4 4 4 4 4 0 0 0 5 0 0 0 4 4 4 4 4 4 4 4 5 5 4 4 4 4 4 4 4 4 4 2 2 2 4
4 4 4 4 4 4 4 4 0 4 4 4 5 5 5 5 5 5 5 5 5 5 5 5 5 5 5 5 5 5 5 5 5 5 5 5 5 4 4 4 4 4 4 4 4 2 2 2 4 4
4 4 4 4 4 4 4 4 0 4 4 4 0 4 4 4 4 4 4 4 0 0 0 5 0 0 0 4 4 4 4 4 4 4 4 4 5 4 4 4 4 4 4 4 2 2 2 4 4 4
4 4 4 4 4 0 4 4 0 4 4 4 0 4 4 4 4 4 4 4 4 0 0 5 0 0 6 4 4 4 4 4 4 4 4 4 5 4 4 4 4 4 4 2 2 2 4 4 4 4
4 4 4 4 4 4 4 4 0 4 4 4 0 4 4 4 4 4 4 4 4 4 6 5 0 0 0 4 4 4 4 4 4 4 4 4 5 4 4 4 4 4 2 2 2 4 4 4 4 4
4 4 4 4 4 4 4 4 0 4 4 4 0 0 0 4 4 4 4 4 4 4 4 5 4 4 4 4 4 4 4 4 4 4 4 4 5 4 4 4 4 2 2 2 4 4 4 4 4 4
4 4 4 4 0 4 4 4 0 4 4 4 4 4 0 4 4 4 4 4 4 4 4 5 4 4 4 4 4 4 4 4 4 4 4 4 5 4 4 4 4 2 2 2 4 4 4 4 4 4
4 4 4 4 4 4 4 4 0 4 4 4 4 4 0 4 4 4 4 4 4 4 4 5 4 4 4 0 4 4 4 4 4 4 4 0 5 4 4 4 4 4 2 2 2 4 4 4 4 4
4 4 4 4 4 4 4 4 0 4 4 4 4 4 0 4 4 4 4 4 4 4 4 5 4 4 4 4 4 4 0 4 4 4 4 4 5 4 4 4 4 4 4 2 2 2 4 4 4 4
4 4 4 4 4 4 0 4 0 0 0 0 0 0 0 4 4 5 7 4 4 4 4 5 4 4 4 4 4 4 0 4 4 4 4 4 5 4 4 4 4 4 4 4 2 2 2 4 4 4
4 4 4 4 4 4 4 4 0 0 0 0 0 0 0 4 5 7 5 4 4 4 4 5 4 4 4 4 4 4 4 4 4 4 4 4 0 4 4 4 4 4 4 4 4 2 2 2 4 4
4 4 4 4 4 4 4 4 0 0 0 0 0 0 0 4 7 7 4 4 4 4 4 5 4 4 4 4 4 4 4 4 4 4 4 0 0 0 4 4 4 4 4 4 4 4 2 2 2 4
4 4 4 4 0 4 4 4 0 0 0 0 0 0 0 4 4 4 4 4 4 4 4 5 4 4 4 4 4 4 4 4 4 4 4 0 0 0 4 4 4 4 4 4 4 4 4 2 2 2
4 4 4 4 4 4 4 0 0 0 0 0 0 0 0 4 4 4 4 4 4 4 4 5 4 4 4 4 4 4 4 4 4 4 4 0 0 0 4 4 4 4 4 4 4 0 4 4 2 2
4 4 4 4 4 4 4 0 0 0 0 0 0 0 0 4 4 0 4 4 4 4 4 5 4 4 4 4 4 4 4 4 4 4 4 0 0 0 4 4 4 0 4 4 4 4 4 4 4 2
4 4 4 4 4 4 4 4 0 0 0 0 0 0 6 4 4 4 4 4 4 4 4 5 4 4 4 4 4 4 4 4 4 4 4 0 0 0 4 4 4 4 4 4 4 4 4 4 4 4
4 4 4 4 4 4 4 3 3 3 3 3 3 3 4 4 4 4 4 0 0 0 0 0 0 0 0 4 4 4 4 4 4 4 0 0 0 0 6 4 4 4 4 4 0 4 4 4 4 4
2 4 4 4 4 4 4 6 3 3 3 3 3 6 4 4 4 4 6 0 0 0 0 0 0 0 0 0 4 4 0 4 6 0 0 0 0 0 0 6 4 4 4 4 4 4 4 4 4 4
2 2 4 6 4 4 4 4 6 3 3 3 4 4 4 4 4 4 0 0 0 0 0 0 0 0 0 0 4 4 4 4 6 0 0 0 0 0 0 4 4 4 4 4 4 4 4 4 4 4
2 2 2 6 6 4 4 4 4 6 6 4 4 4 4 4 4 4 0 0 0 0 0 0 0 0 0 0 0 4 4 4 0 0 0 0 0 4 0 4 4 4 0 4 4 4 4 4 4 4
4 2 2 2 2 4 4 4 4 4 4 4 4 4 4 4 4 4 6 0 0 0 0 0 0 0 0 0 0 0 0 0 0 0 4 0 0 0 0 4 4 4 4 4 4 4 4 0 4 4
4 4 2 2 2 2 2 2 2 2 2 2 6 0 4 4 4 4 4 0 0 0 0 0 0 0 0 4 4 4 4 0 0 0 0 0 0 0 6 4 4 4 4 4 4 4 4 4 4 4
4 4 4 2 2 2 2 2 2 2 2 2 2 6 4 4 4 4 4 4 6 0 0 0 6 0 4 4 4 4 4 6 0 4 0 0 4 0 6 4 4 4 4 4 4 4 4 4 4 4
4 4 4 4 4 4 4 4 4 4 4 2 2 2 4 4 4 4 4 4 4 4 4 4 4 4 4 4 4 4 4 4 6 6 0 0 0 6 4 4 4 4 0 4 4 4 4 4 4 4
4 4 4 4 4 4 4 4 4 4 4 4 2 2 2 4 4 4 4 4 4 4 4 4 4 4 4 4 4 4 4 4 4 4 4 4 4 4 4 4 4 4 4 4 4 4 4 4 4 4
4 4 4 4 4 4 4 4 4 4 4 4 4 2 2 2 4 4 4 4 4 4 4 4 4 4 4 4 4 0 4 4 4 4 4 4 4 4 4 4 4 4 4 4 4 4 0 4 4 4
4 4 4 4 4 4 4 4 4 4 4 4 4 4 2 2 2 4 4 4 4 4 4 4 4 4 4 4 4 4 4 4 4 4 4 4 4 4 4 4 4 4 0 4 4 4 4 4 4 4
4 4 4 4 4 4 4 4 4 4 4 4 4 4 4 2 2 2 4 4 4 4 4 0 4 4 4 4 4 4 4 4 4 4 4 4 0 4 4 4 4 4 4 4 4 4 4 4 4 4
4 4 4 4 4 4 4 4 4 4 4 4 4 4 4 2 2 2 4 4 4 4 4 4 4 4 4 4 4 4 0 4 4 4 4 4 4 4 4 4 4 4 4 4 4 4 4 4 4 4
4 4 4 4 4 4 4 4 4 4 4 4 4 4 4 2 2 2 4 4 4 4 4 4 4 4 4 4 4 4 4 4 4 4 4 4 4 4 4 4 4 4 4 4 4 4 4 4 4 4